10 10
..........
..........
.....#....
.....#....
.....#....
.....#....
.########.
.....#....
.....#....
.B...#..E.
