50 50
........................#.........................
........................#.........................
........................#.........................
........................#.........................
........................#.........................
............#...........#...........#.............
............#...........#...........#.............
............#...........#...........#.............
............#...........#...........#.............
............#...........#...........#.............
............#...........#...........#.............
............#...........#...........#.............
............#...........#...........#.............
............#...........#...........#.............
............#...........#...........#.............
............#...........#...........#.............
............#...........#...........#.............
............#...........#...........#.............
............#...........#...........#.............
............#...........#...........#.............
............#...........#...........#.............
............#...........#...........#.............
............#...........#...........#.............
............#...........#...........#.............
............#...........#...........#.............
............#...........#...........#.............
............#...........#...........#.............
............#...........#...........#.............
............#...........#...........#.............
............#...........#...........#.............
............#...........#...........#.............
............#...........#...........#.............
............#...........#...........#.............
............#...........#...........#.............
............#...........#...........#.............
............#...........#...........#.............
............#...........#...........#.............
............#...........#...........#.............
............#...........#...........#.............
............#...........#...........#.............
............#...........#...........#.............
............#...........#...........#.............
............#...........#...........#.............
............#...........#...........#.............
............#...........#...........#.............
............#...........#...........#..E..........
..........B.#.......................#.............
............#.......................#.............
............#.......................#.............
............#.......................#.............
